0 0 0 0 0 0  0  0  0 0 0  0 0 0  0 0 0 0 18 0 0 0 0 0  0 0 0  0 0 0 18 0 0 0 0  0 0 0 0 0 0 0 0  0 0 0  0 0  0 0 0 0 0 0 0 0 0 18 0 0 0 0 0 0 0 0 0 0 0 0 0  0 0 0  0 0 0 0 0 0 0 0 0 0 0 0 0 0 0 0 0 0 0 0 0 0 0 0 0 18 0 0 0 0 0 18 0 0 0 0 0  0 0 0  0 0 0 0 0 0 0 0 0 0 0 0 0 0 0 0 0 0 0 0 0 0 0 0 0 0 0 0 0 18 0 0 0 0 0 0 0 0 0 0 0 0 0 0 0 0 0 0 0 18 0 0 0 0 0  0 0 0 0 0 18 0 0 0 0 0 0 0 0 0 0 0 0 0 0 0 0 0 0 0 0 0 18 0 0 0 0 0 0 0 0 0 0 0 0 0 0 0 0 18 0 0 0 0 0 0 0 0 0 0 0 18 0 0 0 0 0 0 0 0 0 0 18 0 0 0  0 0 0 0 0  0 0 0  0 0 0 0 0 18 0 0 0 0 0 0 0 0 0 0 0 0 0 0 0 0 0 18 0 0 0 0 0 18 0 0 0 0 0  0 0 0  0 0 0 0 0 0  0 0 0 0 0 0 18 0 0 0 0 0 0 0 0 0 0 0 0 0 0  0 18 0 0 0  0 0 0 0 0 0 0 0  0 18 0 0 0 0 0  0 0 0 0 0 0 0 18 0 0 0 0 0 0 0 18 0 0 0 0 0 0 0 0 0  0 0 0 0 0 0 18 0 0 0 0 0 0 0 18 0 0 0 0 0 0 0 0 18 0 0 0 0 0 0 0 18 0 0 0 0 0 16 0 0 0 0 
0 0 0 0 0 0  0  0  0 0 0  0 0 0  0 0 0 0 0 0 0  0 0 0  0 0 0  0 0 0 0  0 0 0 0  0 0 0 0 0 0 0 0  0 0 0  0 0  0 0 0 0 0 0 0 0 0 0  0 0 0 0 0 0 0 0 0 0 0 0 0  0 0 0  0 0 0 0 0 0 0 0 0 0 0 0 0 0 0 0 0 0 0 0 0 0 0 0 0 0  0 0 0 0 0 0  0 0 0 0 0  0 0 0  0 0 0 0 0 0 0 0 0 0 0 0 0 0 0 0 0 0 0 0 0 0 0 0 0 0 0 0 0 0  0 0 0 0 0 0 0 0 0 0 0 0 0 0 0 0 0 0 0 0  0 0 0 0 0  0 0 0 0 0 0  0 0 0 0 0 0 0 0 0 0 0 0 0 0 0 0 0 0 0 0 0 0  0 0 0 0 0 0 0 0 0 0 0 0 0 0 0 0 0  0 0 0 0 0 0 0 0 0 0 0  0 0 0 0 0 0 0 0 0 0 0 0  0 0 0  0 0 0 0 0  0 0 0  0 0 0 0 0 0 0 0 0 0  0 0 0 0 0 0 0 0 0 0 0 0 0 0  0 0 0 0 0 0  0 0 0 0 0  0 0 0  0 0 0 0 0 0  0 0 0 0 0 0 0  0 0 0 0 0 0 0 0 0 0 0 0 0 0  0 0  0 0 0  0 0 0 0 0 0 0 0  0 0  0 0 0 0 0  0 0 0 0 0 0 0 0  0 0 0 0 0 0 0 0 0 0 0 0  0 0 0 0 0  0 0 0 0 0 0 0  0 0 0 0 0 0 0  0 0 0 0 0 0 0 0 0 0  0 0 0 0 0 0 0 0  0 0 0 0 0 16 0 0 0 0
0 0 0 0 0 0  0  0  0 0 0  0 0 0  0 0 0 0 0 0 0  0 0 0  0 0 0  0 0 0 0  0 0 0 0  0 0 0 0 0 0 0 0  0 0 0  0 0  0 0 0 0 0 0 0 0 0 0  0 0 0 0 0 0 0 0 0 0 0 0 0  0 0 0  0 0 0 0 0 0 0 0 0 0 0 0 3 0 0 0 0 0 0 0 0 0 0 0 0 0  0 0 0 0 0 0  0 0 0 0 0  0 0 0  0 0 0 0 0 0 0 0 0 0 0 0 0 0 0 0 0 0 0 0 0 0 0 0 0 0 0 0 0 0  0 0 0 0 0 0 0 0 0 0 0 0 0 0 0 0 0 0 0 0  0 0 0 0 0  0 0 0 0 0 0  0 0 0 0 0 0 0 0 0 0 0 0 0 0 0 0 0 0 0 0 0 0  0 0 0 0 0 0 0 0 0 0 0 0 0 0 0 0 0  0 0 0 0 0 0 0 0 0 0 14 0 0 9 0 0 0 0 0 0 0 0 0  0 0 0  0 0 0 0 0  0 0 0  0 0 0 0 0 0 6 0 0 0  0 0 0 0 0 0 0 0 0 0 0 0 0 0  0 0 0 0 0 0  0 0 0 0 0  0 0 0  0 0 0 0 0 0  0 0 0 0 0 0 0  0 0 0 0 0 0 3 3 3 3 3 0 0 0  0 0  0 0 0  0 0 0 0 0 0 0 0  0 0  0 0 0 0 0  0 0 0 0 0 0 0 0  0 0 0 0 0 0 0 0 0 0 0 0  0 0 0 0 0  0 0 0 0 0 0 0  0 0 0 0 0 0 0  0 0 0 0 0 0 0 0 0 0  0 0 0 0 0 0 0 0  0 0 0 0 0 15 0 0 0 0  
0 0 0 0 0 12 0  0  0 0 0  0 0 0  0 0 0 0 0 0 0  0 0 0  0 0 0  0 0 0 0  0 0 0 0  0 0 6 0 0 0 0 0  0 0 0  0 0  0 0 0 0 0 0 0 0 0 0  0 0 0 0 0 0 0 0 0 0 0 0 0  0 0 0  0 0 0 0 0 0 0 0 0 0 0 0 4 0 0 0 0 0 0 0 0 0 0 0 0 0  0 0 0 0 0 0  0 0 0 0 0  0 0 12 0 0 0 0 0 0 0 0 0 0 0 0 0 0 0 0 3 3 3 3 0 0 0 0 0 0 0 0 0 0  0 0 0 0 0 0 0 0 0 0 0 0 0 0 0 0 0 0 0 0  0 0 0 0 0  0 0 0 0 0 0  0 0 0 0 0 0 0 0 0 0 0 0 0 0 0 0 0 0 0 0 0 0  0 0 0 0 0 0 0 0 0 0 0 0 0 0 0 0 0  0 0 0 0 0 0 0 0 0 0 9  0 0 0 0 0 0 0 0 0 0 0 0  0 0 12 0 0 0 0 0  0 0 0  0 0 0 0 0 0 6 0 0 0  0 0 0 0 0 0 0 0 0 0 0 0 0 0  0 0 0 0 0 0  0 0 0 0 0  0 0 0  0 0 0 0 0 10 0 0 0 0 0 0 0  0 0 0 0 0 0 0 0 0 0 0 0 0 12 0 0  0 0 0  0 0 0 0 0 0 0 0  0 0  0 0 0 0 0  0 0 0 0 0 0 9 9  9 0 0 0 0 0 0 0 0 0 0 0  0 0 0 0 0  0 0 0 0 0 0 0  0 0 0 0 0 0 0  0 0 0 0 0 0 0 0 0 0  0 0 0 0 0 0 0 0  0 0 0 0 0 16 0 0 0 0    
0 0 0 0 0 0  0  0  0 0 0  0 0 17 0 0 0 0 0 0 0  0 0 0  0 0 0  0 0 0 0  0 0 0 11 0 6 6 0 0 0 0 0  6 0 10 0 14 0 0 0 0 0 0 0 0 0 0  0 0 0 0 0 0 0 0 0 0 0 0 0  0 0 0  0 0 0 0 0 0 0 0 0 3 0 0 0 0 0 0 7 8 0 0 0 0 0 0 0 0  0 0 0 0 0 0  0 0 0 0 0  0 0 0  0 0 0 0 0 0 0 0 0 0 0 0 0 0 0 0 0 0 0 0 0 0 0 0 0 0 0 17 0 0 0 0 0 0 0 0 0 0 0 0 7 3 8 0 0 0 0 0 0 0  0 0 0 0 0  0 0 0 0 0 0  0 0 0 0 0 0 0 0 0 0 0 0 0 0 0 0 0 0 0 0 0 0  0 0 0 0 0 0 0 0 0 0 0 0 0 0 0 0 0  0 7 8 0 0 0 9 0 0 0 0  0 0 0 0 0 0 0 0 0 0 0 0  0 0 0  0 0 0 0 0  0 0 0  0 0 9 9 0 0 6 0 0 17 0 0 0 0 0 0 0 0 0 0 0 0 0 0  0 0 0 0 0 0  0 0 0 0 19 0 0 11 0 0 0 0 9 9  9 0 0 0 0 0 0  0 0 0 0 0 0 0 0 0 0 0 0 0 0  0 0  0 0 0  0 0 0 0 0 0 0 0  0 0  0 0 0 0 0  0 0 0 0 0 0 0 0  0 0 0 0 0 0 0 0 0 0 0 17 0 0 0 0 0  0 0 0 0 0 0 0  0 0 0 0 0 0 0  0 0 0 0 0 0 0 0 0 0  0 0 0 0 17 0 0 0 0 0 0 0 0 16 0 0 0 0  
0 0 0 0 0 0  0  0  0 0 0  0 0 0  0 6 0 0 0 0 0  0 0 0  0 0 0  0 4 0 3  0 0 7 3  3 3 8 0 0 0 0 0  7 3 3  3 8  0 0 0 0 0 0 0 0 9 9  9 0 0 0 0 0 0 0 0 0 0 0 11 0 0 0 10 0 0 0 0 0 0 0 0 0 0 0 0 0 0 7 2 1 0 0 0 9 0 0 0 0  0 0 0 0 0 0  0 0 0 0 0  0 0 0  0 0 0 0 0 0 0 0 0 0 0 0 0 0 0 0 0 0 0 0 0 0 0 0 0 0 0 0 0 0  0 0 0 0 0 0 0 0 0 0 5 2 1 0 0 0 0 0 0 0  0 0 0 0 0  0 0 0 0 0 0  0 0 0 3 0 0 3 0 0 3 0 0 0 7 3 0 0 0 0 6 0 0  0 0 0 0 3 0 0 0 0 3 0 0 0 0 3 0 0  0 5 1 0 0 0 0 0 0 0 0  0 4 0 0 0 4 4 3 3 0 0 0  0 0 0  0 0 0 0 0  0 0 0  0 0 0 0 0 0 6 0 0 0  0 0 0 0 0 0 0 0 0 0 0 0 0 19 0 0 0 0 0 0  0 0 7 3 3  3 3 3  3 3 8 0 0 0  0 0 0 0 0 0 10 0 0 0 0 0 0 0 0 0 0 0 0 0 0  0 0  0 0 0  0 0 0 7 8 0 0 0  0 0  0 0 0 0 0  0 9 9 0 0 0 0 0  0 0 0 6 0 0 0 0 0 0 0 0  0 0 0 0 0  0 0 0 0 0 9 9  0 0 0 0 0 0 10 0 0 0 0 0 0 0 0 0 0  0 0 0 0 0 0 0 0  0 0 0 0 0 16 0 0 0 0  
3 0 0 0 0 10 10 10 0 0 11 0 0 11 6 6 6 0 0 0 11 0 0 10 0 0 13 0 0 0 0  0 0 5 2  2 2 1 0 0 0 0 0  5 2 2  2 1  0 0 0 0 0 9 0 0 0 0  0 0 0 0 0 0 0 0 0 0 7 3 3  3 3 3  3 3 8 0 0 0 0 0 0 0 0 0 9 0 0 5 2 2 3 8 0 0 0 0 0 0  0 0 0 0 0 0  0 0 0 0 19 0 0 10 0 0 0 0 0 0 0 0 0 0 0 0 0 0 0 0 3 0 0 0 0 0 0 0 0 0 0 19 0 0 0 0 0 0 0 0 0 0 0 7 2 2 2 8 0 0 0 0 19 0 0 0 0 0 10 0 0 0 0 0 0  0 0 0 2 0 0 2 0 0 2 0 0 0 0 2 0 0 0 0 6 6 0  0 0 0 0 2 0 0 0 0 2 0 0 0 0 2 0 0  6 5 1 0 0 0 0 0 0 0 0  0 0 0 0 0 0 0 0 0 0 0 11 0 0 0 10 0 0 0 19 0 0 13 6 0 0 0 0 0 6 0 0 0  0 0 0 0 0 0 0 0 0 0 7 3 3 3  3 3 8 0 0 0  0 0 5 2 2  2 2 2  2 2 1 0 0 0  0 0 0 0 7 3 3  3 3 8 0 0 0 0 0 0 0 0 0 0 10 0 0  0 0 11 0 0 0 5 1 0 0 11 0 0  0 0 0 0 13 0 0 0 0 0 0 0 10 0 0 6 6 6 0 0 0 0 0 0 0  0 0 0 0 11 0 0 0 0 0 0 0  0 0 0 0 0 7 3  3 8 0 0 0 0 0 0 0 11 0 0 0 0 0 0 0 19 0 0 0 0 0 16 0 0 0 0  
2 3 3 3 3 3  3  3  3 3 3  3 3 3  3 3 3 3 3 3 3  3 3 3  3 3 8  0 0 0 0  0 0 5 2  2 2 1 0 0 0 0 0  5 2 2  2 1  0 0 4 0 0 0 0 0 0 0  0 0 0 0 0 0 0 0 0 0 5 2 2  2 2 2  2 2 1 0 0 0 0 0 0 9 0 0 0 0 0 5 2 2 2 1 0 0 0 0 9 9  0 0 3 3 3 3  3 3 3 3 3  3 3 3  3 3 3 3 3 3 3 4 4 3 3 3 4 4 4 3 0 0 0 0 7 3 3 3 3 3 3 3 3 3  3 3 3 3 3 3 3 3 3 2 2 2 2 2 3 3 3 3 3 3  3 3 3 3 3  3 3 3 3 3 3  8 0 0 2 0 0 2 0 0 2 0 0 0 0 2 8 0 0 7 3 3 3  3 3 3 3 2 3 3 3 3 2 3 3 3 3 2 3 3  3 2 1 0 0 0 0 0 0 0 0  0 0 0 0 0 0 0 0 0 3 3 3  3 3 3  3 3 3 3 3  3 3 3  3 3 3 3 3 3 3 3 3 3  3 3 3 3 3 3 3 0 0 0 5 2 2 2  2 2 1 0 0 9  0 0 5 2 2  2 2 2  2 2 1 0 0 0  0 0 0 0 5 2 2  2 2 1 0 0 0 7 3 3 3 3 3 3 3  3 3  3 3 3  3 3 3 2 2 3 3 3  3 3  3 3 3 3 8  0 0 0 0 7 3 3 3  3 3 3 3 3 3 3 3 3 3 3 3  3 3 3 3 3  3 3 8 0 0 0 0  0 0 7 3 3 2 2  2 2 3 3 3 3 3 3 3 3  3 3 3 3 3 3 3 3  3 3 3 3 3 3  3 3 3 3
2 2 2 2 2 2  2  2  2 2 2  2 2 2  2 2 2 2 2 2 2  2 2 2  2 2 1  0 0 0 0  0 0 5 2  2 2 1 0 0 0 0 0  5 2 2  2 1  0 0 2 0 0 0 0 0 0 0  0 0 0 0 7 3 8 0 0 7 2 2 2  2 2 2  2 2 1 0 0 0 9 0 0 0 0 0 0 0 0 5 2 2 2 1 0 0 0 0 0 0  0 0 0 0 0 0  0 0 0 0 0  0 0 0  0 0 0 0 0 0 0 0 0 0 0 0 0 0 0 0 0 0 0 0 5 2 2 2 2 2 2 2 2 2  2 2 2 2 2 2 2 2 2 2 2 2 2 2 2 2 2 2 2 2  2 2 2 2 2  2 2 2 2 2 2  1 0 0 2 0 0 2 0 0 2 0 0 0 0 2 0 0 0 5 2 2 2  2 2 2 2 2 2 2 2 2 2 2 2 2 2 2 2 2  2 2 1 0 0 0 0 0 0 0 0  0 0 0 0 0 0 0 0 0 2 2 2  2 2 2  2 2 2 2 2  2 2 2  2 2 2 2 2 2 2 2 2 2  2 2 2 2 2 2 2 0 0 0 5 2 2 2  2 2 1 0 0 0  0 0 5 2 2  2 2 2  2 2 1 0 0 0  0 0 0 0 5 2 2  2 2 1 0 0 0 5 2 2 2 2 2 2 2  2 2  2 2 2  2 2 2 2 2 2 2 2  2 2  2 2 2 2 1  0 0 0 0 5 2 2 2  2 2 2 2 2 2 2 2 2 2 2 2  2 2 2 2 2  2 2 1 0 0 0 0  0 0 5 2 2 2 2  2 2 2 2 2 2 2 2 2 2  2 2 2 2 2 2 2 2  2 2 2 2 2 2  2 2 2 2
2 2 2 2 2 2  2  2  2 2 2  2 2 2  2 2 2 2 2 2 2  2 2 2  2 2 1  0 0 0 0  0 0 5 2  2 2 1 0 0 0 0 0  5 2 2  2 1  0 0 2 0 0 0 0 0 0 0  0 0 0 0 5 2 1 0 0 5 2 2 2  2 2 2  2 2 1 0 0 0 0 0 0 0 0 0 0 0 0 5 2 2 2 1 0 0 0 0 0 0  0 0 0 0 0 0  0 0 0 0 0  0 0 0  0 0 0 0 0 0 0 0 0 0 0 0 0 0 0 0 0 0 0 0 5 2 2 2 2 2 2 2 2 2  2 2 2 2 2 2 2 2 2 2 2 2 2 2 2 2 2 2 2 2  2 2 2 2 2  2 2 2 2 2 2  1 0 0 2 0 0 2 0 0 2 0 0 0 0 2 0 0 0 5 2 2 2  2 2 2 2 2 2 2 2 2 2 2 2 2 2 2 2 2  2 2 1 0 0 0 0 0 0 0 0  0 0 0 0 0 0 0 0 0 2 2 2  2 2 2  2 2 2 2 2  2 2 2  2 2 2 2 2 2 2 2 2 2  2 2 2 2 2 2 2 0 0 0 5 2 2 2  2 2 1 0 0 0  0 0 5 2 2  2 2 2  2 2 1 0 0 0  0 0 0 0 5 2 2  2 2 1 0 0 0 5 2 2 2 2 2 2 2  2 2  2 2 2  2 2 2 2 2 2 2 2  2 2  2 2 2 2 1  0 0 0 0 5 2 2 2  2 2 2 2 2 2 2 2 2 2 2 2  2 2 2 2 2  2 2 1 0 0 0 0  0 0 5 2 2 2 2  2 2 2 2 2 2 2 2 2 2  2 2 2 2 2 2 2 2  2 2 2 2 2 2  2 2 2 2